{
    "01": "A",
    "02": "A",
    "03": "A",
    "05": "B",
    "06": "B",
    "07": "B",
    "08": "B",
    "09": "B",
    "10": "C",
    "11": "C",
    "12": "C",
    "13": "C",
    "14": "C",
    "15": "C",
    "16": "C",
    "17": "C",
    "18": "C",
    "19": "C",
    "20": "C",
    "21": "C",
    "22": "C",
    "23": "C",
    "24": "C",
    "25": "C",
    "26": "C",
    "27": "C",
    "28": "C",
    "29": "C",
    "30": "C",
    "31": "C",
    "32": "C",
    "33": "C",
    "35": "D",
    "36": "E",
    "37": "E",
    "38": "E",
    "39": "E",
    "41": "F",
    "42": "F",
    "43": "F",
    "46": "G",
    "47": "G",
    "49": "H",
    "50": "H",
    "51": "H",
    "52": "H",
    "53": "H",
    "55": "I",
    "56": "I",
    "58": "J",
    "59": "J",
    "60": "J",
    "61": "K",
    "62": "K",
    "63": "K",
    "64": "L",
    "65": "L",
    "66": "L",
    "68": "M",
    "69": "N",
    "70": "N",
    "71": "N",
    "72": "N",
    "73": "N",
    "74": "N",
    "75": "N",
    "77": "O",
    "78": "O",
    "79": "O",
    "80": "O",
    "81": "O",
    "82": "O",
    "84": "P",
    "85": "Q",
    "86": "R",
    "87": "R",
    "88": "R",
    "90": "S",
    "91": "S",
    "92": "S",
    "93": "S",
    "94": "T",
    "95": "T",
    "96": "T",
    "97": "U",
    "98": "U",
    "99": "V"
}